1111111111111
1001000C00101
1000011100111
1P00010001E01
1111111111111